10 5
# @ # + # + # + # #
# + # + + + + + + +
# + # + # # # + # +
# + # + # $ # # # +
# + + + # + + + + +